11111111111111111111
1C000000000000000001
1110000000000P000001
100000000K0000000001
10000000000000111111
10111111110000000001
1C111110000000000E01
11111111111111111111
